"K": 0, "title": "", "M": 21, "N": 31
#####################
#...#.#.......#.....#
#.#.#.#.#####.#.#.###
#.#...#.....#...#...#
#.#####.###########.#
#.......#...#.....#.#
#.#######.#.#.###.#.#
#.....#...#x..#.....#
#######.###.#########
#.......#.#.#.......#
#.#######.#.#.#####.#
#.#.....#...#...#.#.#
#.#.###.###.###.#.#.#
#.#.#.#...#.#...#.#.#
#.#.#.###.###.###.#.#
#.#...#.#...#.#...#.#
#.###.#.###.#.#.###.#
#...#.....#...#.#...#
#.#.#####.#####.#.#.#
#.#.#...#...#...#.#.#
#.#.#.#####.###.#.###
#.#...#...#.....#...#
#.###.#.#.#####.###.#
#...#.#.#.#.......#.#
#.#.###.#.#.#######.#
#.#.#...#...#.....#.#
#.#.#.#######.###.#.#
#.#.#.....#.#.#s..#.#
#.#.#####.#.#.#####.#
#.#.........#.......#
#####################