"K": 0, "title": "", "M": 5, "N": 11
#####
##.s#
#..##
##.##
#..##
##..#
#..##
##..#
#..##
##.x#
#####
