"K": 0, "title": "", "M": 29, "N": 9
#############################
#...........#.........#.....#
#.###.#######.#.#####.#.#####
#.#...#.....#.#...#.#.#.....#
#.#.###.###.#.###.#.#.#####.#
#.#.#...#s#...#...#x#.#...#.#
#.#.#.###.#####.###.#.#.#.#.#
#.#.....#.......#.......#...#
#############################